11111111111111111111111111111111111111111111111111111111111111111111111111111111
11111111111111111111111111111111111111111111111111111111111111111111111111111111
11111111111111111111111111111111111111111111111111111111111111111111111111111111
1111........................................................................1111
111..................................................................P.......111
111.........................................P................................111
111..........................................................................111
111..........................................................................111
111..........................................................................111
111..........................................................................111
111..........................................................................111
111..........................................................................111
111.................................P........................................111
111..........................................................................111
111..........................................................................111
111..........................................................................111
111..........................................................................111
111........................................................P.................111
111..........................................................................111
111..........................................................................111
111..........................................................................111
111..........................................................................111
111..........................................................................111
111..........................................................................111
111..........................................................................111
111..........................................................................111
111..........................................................................111
111..........................................................................111
111..........................................................................111
111..........................................................................111
111..........................................................................111
111........................................................P.................111
111..........................................................................111
111..........................................................................111
111..........................................................................111
111..........................................................................111
111..........................................................................111
111..........................................................................111
111..........................................................................111
111.......................................................P..................111
111..........................................................................111
111..........................................................................111
111..........................................................................111
111..........................................................................111
111..........................................................................111
111..........................................................................111
111..........................................................................111
111..........................................................................111
111..........................................................................111
111.................................................P........................111
111..........................................................................111
111..........................................................................111
111..........................................................................111
111..........................................................................111
111..........................................................................111
111..............P...........................................................111
111....................................................P.....................111
111..........................................................................111
111..........................................................................111
111..........................................................................111
1111........................................................................1111
11111111111111111111111111111111111111111111111111111111111111111111111111111111
11111111111111111111111111111111111111111111111111111111111111111111111111111111
11111111111111111111111111111111111111111111111111111111111111111111111111111111
